NO 0,0,0
SO 100,0,0
WE 0,100,0
EA 0,0,100

F 255,255,255
C 150,10,200

            11111111111
         11110000000001111
       111000001111000000111
      1100000111  11110000011
      10000011       11000001
      10000011       11000001
      1100000111  11110000011
       111000001111000000111
         11110000S00001111
            11111111111