NO ./colorstone.xpm
SO ./greystone.xpm
WE ./mossy.xpm
EA ./redbrick.xpm

F 220,100,0
C 225,30,0

        1111111111111111111111111
        1000000000110000000000001
        10110000011100N0000000001
        1001000000000000000000001
111111111111111111111111111111111